{
    "meta": {},
    "links": {},
    "data": {
        "room": {
            "id": "inb1101",
            "dimensions": {
                "x": 9,
                "y": 12
            },
            "map": [
                "..", "..", "..", "..", "..", "..", "..", "..", "..",
                "..", "..", "..", "E1", "E2", "E3", "E4", "E5", "E6",
                "F1", "..", "..", "D1", "D2", "D3", "D4", "D5", "D6",
                "..", "..", "..", "..", "..", "..", "..", "..", "..",
                "..", "..", "..", "..", "..", "..", "..", "..", "..",
                "..", "..", "..", "C1", "C2", "C3", "C4", "C5", "C6",
                "..", "..", "..", "B1", "B2", "B3", "B4", "B5", "B6",
                "..", "..", "..", "..", "..", "..", "..", "..", "..",
                "..", "..", "..", "..", "..", "..", "..", "..", "..",
                "..", "..", "..", "..", "..", "A1", "A2", "A3", "A4",
                "..", "..", "..", "..", "..", "..", "..", "..", "..",
                "..", "..", "..", "..", "..", "..", "..", "..", ".."
            ]
        }
    }
}